1 1 1 1 1 1 1 1 1 1 1 1 1 1 1 1 1 1 1 1 1 1 1 1 1 1 1 1 1 1 1 1 1 1 1 1 1 1 1 1
1 46 46 46 46 46 46 46 46 46 46 46 46 46 46 46 46 46 46 46 46 46 46 46 46 46 46 46 46 46 46 46 46 46 46 46 46 46 46 1
1 46 45 45 45 45 45 45 45 45 45 45 45 45 45 45 45 45 45 45 45 45 45 45 45 45 45 45 45 45 45 45 45 45 45 45 45 45 46 1
1 46 45 45 45 45 45 45 45 45 45 45 45 45 45 45 45 45 45 45 45 45 45 45 45 45 45 45 45 45 45 45 45 45 45 45 45 45 46 1
1 46 45 45 45 45 45 45 53 53 53 53 53 53 53 53 53 53 53 53 53 53 53 53 53 53 53 53 53 53 45 45 45 45 45 45 45 45 46 1
1 46 45 45 45 45 45 45 53 45 45 45 45 45 45 45 45 45 45 45 45 45 45 45 45 45 45 45 45 53 45 45 45 45 45 45 45 45 46 1
1 46 45 45 45 45 45 45 53 45 45 45 45 45 45 45 45 45 45 45 45 45 45 45 45 45 45 45 45 53 45 45 45 45 45 45 45 45 46 1
1 46 45 45 45 45 45 45 53 45 45 45 45 50 50 50 50 50 50 50 50 50 50 50 50 50 45 45 45 53 45 45 45 45 45 45 45 45 46 1
1 46 45 45 45 45 45 45 53 45 45 45 45 40 54 45 45 45 45 45 45 45 45 52 52 41 45 45 45 53 45 45 45 45 45 45 45 45 46 1
1 46 45 45 45 45 45 45 53 45 45 45 45 40 45 45 45 45 45 45 45 45 45 45 52 41 45 45 45 53 45 45 45 45 45 45 45 45 46 1
1 46 45 45 45 45 45 45 53 45 45 45 45 40 45 45 45 45 45 45 45 45 45 45 45 41 45 45 45 53 45 45 45 45 45 45 45 45 46 1
1 46 45 45 45 45 45 45 53 45 45 45 45 40 45 45 34 35 45 45 34 35 45 45 45 41 45 45 45 53 45 45 45 45 45 45 45 45 46 1
1 46 28 45 45 45 45 45 53 45 45 45 45 45 45 45 36 37 45 45 36 37 45 45 45 41 45 45 45 53 45 45 45 45 45 45 45 28 46 1
1 46 27 53 53 53 53 53 53 53 53 53 53 45 45 45 45 45 45 45 45 45 45 45 45 41 45 45 45 53 53 53 53 53 53 53 53 29 46 1
1 46 28 45 45 45 45 45 53 45 45 45 45 45 45 45 45 45 45 26 45 45 45 45 45 41 45 45 45 53 45 45 45 45 45 45 45 28 46 1
1 46 45 45 45 45 45 45 53 45 45 45 45 40 45 45 45 34 35 45 45 45 45 45 45 41 45 45 45 53 45 45 45 45 45 45 45 45 46 1
1 46 45 45 45 45 45 45 53 45 45 45 45 40 45 45 45 36 37 45 45 45 45 45 45 41 45 45 45 53 45 45 45 45 45 45 45 45 46 1
1 46 45 45 45 45 45 45 53 45 45 45 45 40 45 45 45 45 45 45 45 45 45 45 42 41 45 45 45 53 45 45 45 45 45 45 45 45 46 1
1 46 45 45 45 45 45 45 53 45 45 45 45 40 45 45 45 45 45 45 45 45 42 42 42 41 45 45 45 53 45 45 45 45 45 45 45 45 46 1
1 46 45 45 45 45 45 45 53 45 45 45 45 40 45 45 45 45 45 45 45 45 42 42 42 41 45 45 45 53 45 45 45 45 45 45 45 45 46 1
1 46 45 45 45 45 45 45 53 45 45 45 45 50 50 50 50 50 50 50 50 50 50 50 50 50 45 45 45 53 45 45 45 45 45 45 45 45 46 1
1 46 45 45 45 45 45 45 53 45 45 45 45 45 45 45 45 45 45 45 45 45 45 45 45 45 45 45 45 53 45 45 45 45 45 45 45 45 46 1
1 46 45 45 45 45 45 45 53 45 45 45 45 45 45 45 45 45 45 45 45 45 45 45 45 45 45 45 45 53 45 45 45 45 45 45 45 45 46 1
1 46 45 45 45 45 45 45 53 45 45 45 45 45 45 45 45 45 45 45 45 45 45 45 45 45 45 45 45 53 45 45 45 45 45 45 45 45 46 1
1 46 45 45 45 45 45 45 53 45 45 45 45 45 45 45 45 45 45 45 45 45 45 45 45 45 45 45 45 53 45 45 45 45 45 45 45 45 46 1
1 46 45 45 45 45 45 45 53 53 53 53 53 53 53 53 53 53 53 53 53 53 53 53 53 53 53 53 53 53 45 45 45 45 45 45 45 45 46 1
1 46 45 45 45 45 45 45 45 45 45 45 45 45 45 45 45 45 45 45 45 45 45 45 45 45 45 45 45 45 45 45 45 45 45 45 45 45 46 1
1 46 45 45 45 45 45 45 45 45 45 45 45 45 45 45 45 45 45 45 45 45 45 45 45 45 45 45 45 45 45 50 50 50 50 50 50 50 46 1
1 46 45 45 45 45 45 45 45 45 45 45 45 45 45 45 45 45 45 45 45 45 45 45 45 45 45 45 45 45 45 40 56 45 56 45 56 45 46 1
1 46 45 45 45 45 45 45 45 45 45 45 45 45 45 45 45 45 45 45 45 45 45 45 45 45 45 45 45 45 45 40 55 45 55 45 55 45 46 1
1 46 45 45 45 45 45 45 45 45 45 45 45 45 45 45 45 45 45 45 45 45 45 45 45 45 45 45 45 45 45 40 45 45 45 45 45 45 46 1
1 46 45 45 45 45 45 45 45 45 45 45 45 45 45 45 45 45 45 45 45 45 45 45 45 45 45 45 45 45 45 45 45 45 45 45 45 45 46 1
1 46 45 45 45 45 45 45 45 45 45 45 45 45 45 45 45 28 45 28 45 45 45 45 45 45 45 45 45 45 45 45 45 45 45 45 45 45 46 1
1 46 46 46 46 46 46 46 46 46 46 46 46 46 46 46 46 46 59 46 46 46 46 46 46 46 46 46 46 46 46 46 46 46 46 46 46 46 46 1
1 1 1 1 1 1 1 1 1 1 1 1 1 1 1 1 1 1 1 1 1 1 1 1 1 1 1 1 1 1 1 1 1 1 1 1 1 1 1 1