1 1 1 1 1 1 1 1 1 1 1 1 1 1 1 1 1 1 1 1 1 1 1 1 1 1 1 1 1 1 1 1 1 1 1 1 1 1 1 1
1 7 7 7 7 7 7 7 7 7 7 7 7 7 7 7 7 7 7 7 7 7 7 7 7 7 7 7 7 7 7 7 7 7 7 7 7 7 7 1
1 33 45 45 34 35 45 45 34 35 45 45 34 35 45 45 34 35 45 45 34 35 45 45 34 35 45 45 34 35 45 45 34 35 45 45 45 45 33 1
1 33 45 45 36 37 45 45 36 37 45 45 36 37 45 45 36 37 45 45 36 37 45 45 36 37 45 45 36 37 45 45 36 37 45 45 45 45 33 1
1 33 9 9 45 45 9 9 45 45 9 9 45 45 9 9 45 45 9 9 45 45 9 9 45 45 9 9 45 45 9 9 45 45 9 9 9 9 33 1
1 33 45 45 30 31 45 45 30 31 45 45 30 31 45 45 30 31 45 45 30 31 45 45 30 31 45 45 30 31 45 45 30 31 45 45 45 45 33 1
1 33 45 45 45 45 45 45 45 45 45 45 45 45 45 45 45 45 45 45 45 45 45 45 45 45 45 45 45 45 45 45 45 45 45 45 45 45 33 1
1 33 45 53 53 53 53 53 53 53 53 53 53 53 53 53 53 53 53 53 53 53 53 53 53 53 53 53 53 53 53 53 53 53 53 53 53 45 33 1
1 33 45 45 45 45 45 53 45 45 45 45 45 45 53 45 45 45 45 45 45 45 53 45 45 45 45 45 45 45 53 45 45 45 45 45 45 45 33 1
1 33 45 45 45 45 45 53 45 45 45 45 45 45 53 45 45 45 45 45 45 45 53 45 45 45 45 45 45 45 53 45 45 45 45 45 45 45 33 1
1 33 45 45 45 45 45 53 45 45 45 45 45 45 53 45 45 45 45 45 45 45 53 45 45 45 45 45 45 45 53 45 45 45 45 45 45 45 33 1
1 33 45 45 45 45 45 53 45 45 45 45 45 45 53 45 45 45 45 45 45 45 53 45 45 45 45 45 45 45 53 45 45 45 45 45 45 45 33 1
1 33 45 45 45 45 45 53 45 45 9 9 45 45 53 45 45 45 9 9 45 45 53 45 45 45 9 9 45 45 53 45 45 45 45 45 45 45 33 1
1 33 28 28 45 45 45 53 45 9 47 47 9 45 53 45 45 9 47 47 9 45 53 45 45 9 47 47 9 45 53 45 45 45 45 45 28 28 33 1
1 33 27 45 45 45 45 53 45 9 47 47 9 45 53 45 45 9 47 47 9 45 53 45 45 9 47 47 9 45 53 45 45 45 45 45 45 29 33 1
1 33 28 28 45 45 45 53 45 45 9 9 45 45 53 45 45 45 9 9 45 45 53 45 45 45 9 9 45 45 53 45 45 45 45 45 28 28 33 1
1 33 45 45 45 45 45 53 45 45 45 45 45 45 53 45 45 45 45 45 45 45 53 45 45 45 45 45 45 45 53 45 45 45 45 45 45 45 33 1
1 33 45 45 45 45 45 53 53 53 53 53 53 53 53 53 53 53 53 53 53 53 53 53 53 53 53 53 53 53 53 45 45 45 45 45 45 45 33 1
1 33 45 45 45 45 45 53 45 45 9 9 45 45 53 45 45 45 9 9 45 45 53 45 45 45 9 9 45 45 53 45 45 45 45 45 45 45 33 1
1 33 45 45 45 45 45 53 45 9 47 47 9 45 53 45 45 9 47 47 9 45 53 45 45 9 47 47 9 45 53 45 45 45 45 45 45 45 33 1
1 33 45 45 45 45 45 53 45 9 47 47 9 45 53 45 45 9 47 47 9 45 53 45 45 9 47 47 9 45 53 45 45 45 45 45 45 45 33 1
1 33 45 45 45 45 45 53 45 45 9 9 45 45 53 45 45 45 9 9 45 45 53 45 45 45 9 9 45 45 53 45 45 45 45 45 45 45 33 1
1 33 45 45 45 45 45 53 45 45 45 45 45 45 53 45 45 45 45 45 45 45 53 45 45 45 45 45 45 45 53 45 45 45 45 45 45 45 33 1
1 33 45 45 45 45 45 53 53 53 53 53 53 53 53 53 53 53 53 53 53 53 53 53 53 53 53 53 53 53 53 45 45 45 45 45 45 45 33 1
1 33 45 45 45 45 45 45 45 45 45 45 45 45 45 45 45 45 45 45 45 45 45 45 45 45 45 45 45 45 45 45 45 45 45 45 45 45 33 1
1 33 45 45 45 45 45 45 45 45 45 45 45 45 45 45 45 45 45 45 45 45 45 45 45 45 45 45 45 45 45 45 45 45 45 45 45 45 33 1
1 33 45 45 45 45 45 45 45 45 45 45 45 45 45 45 45 45 45 45 45 45 45 45 45 45 45 45 45 45 45 45 45 45 45 45 45 45 33 1
1 33 45 45 45 45 45 45 45 45 45 45 45 45 45 45 45 45 45 45 45 45 45 45 45 45 45 45 45 45 45 45 45 45 45 45 45 45 33 1
1 33 45 45 45 45 45 45 45 45 45 45 45 45 45 45 45 45 45 45 45 45 45 45 45 45 45 45 45 45 45 45 45 45 45 45 45 45 33 1
1 33 45 45 45 45 45 45 45 45 45 45 45 45 45 45 45 45 45 45 45 45 45 45 45 45 45 45 45 45 45 45 45 45 45 45 45 45 33 1
1 33 45 45 45 45 45 45 45 45 45 45 45 45 45 45 45 45 45 45 45 45 45 45 45 45 45 45 45 45 45 45 45 45 45 45 45 45 33 1
1 45 45 33 45 33 45 33 45 33 45 33 45 33 45 33 45 33 45 33 45 33 45 33 45 33 45 33 45 33 45 33 45 33 45 33 45 33 45 1
1 7 7 7 7 7 7 7 7 7 7 7 7 7 7 7 7 7 7 7 7 7 7 7 7 7 7 7 7 7 7 7 7 7 7 7 7 7 7 1
1 45 45 45 45 45 45 45 45 45 45 45 45 45 45 45 45 45 45 45 45 45 45 45 45 45 45 45 45 45 45 45 45 45 45 45 45 45 45 1
1 1 1 1 1 1 1 1 1 1 1 1 1 1 1 1 1 1 1 1 1 1 1 1 1 1 1 1 1 1 1 1 1 1 1 1 1 1 1 1