1 1 1 1 1 1 1 1 1 1 1 1 1 1 1 1 1 1 1 1 1 1 1 1 1 1 1 1 1 1 1 1 1 1 1 1 1 1 1 1
1 8 8 8 8 8 8 8 8 8 8 8 8 8 8 8 8 8 8 8 8 8 8 8 8 8 8 8 8 8 8 8 8 8 8 8 8 8 8 1
1 15 15 15 15 15 15 15 15 15 15 15 15 15 15 15 58 15 15 15 15 15 15 15 15 15 15 15 15 15 15 15 15 15 15 15 15 15 15 1
1 8 0 0 0 0 0 0 0 0 0 0 0 0 0 28 0 28 0 0 0 0 0 0 0 0 0 0 0 0 0 0 0 0 0 0 0 0 8 1
1 8 0 11 12 0 0 0 0 11 12 0 0 0 0 0 32 0 0 0 0 11 12 0 0 0 0 11 12 0 0 0 0 11 12 0 0 0 8 1
1 8 0 13 14 0 0 0 0 13 14 0 0 0 0 0 32 0 0 0 0 13 14 0 0 0 0 13 14 0 0 0 0 13 14 0 0 0 8 1
1 8 0 0 0 0 0 0 0 0 0 0 0 0 0 0 32 0 0 0 0 0 0 0 0 0 0 0 0 0 0 0 0 0 0 0 0 0 8 1
1 8 0 0 0 0 0 0 0 0 0 0 0 0 0 0 32 0 0 0 0 0 0 0 0 0 0 0 0 0 0 0 0 0 0 0 0 0 8 1
1 8 0 0 32 32 32 32 32 32 32 32 32 32 32 32 32 32 32 32 32 32 32 32 32 32 32 32 32 32 32 32 32 32 32 0 0 0 8 1
1 8 0 0 32 0 0 0 0 0 0 0 0 0 0 0 0 0 0 0 0 0 0 0 0 0 0 0 0 0 0 0 0 0 32 0 0 0 8 1
1 8 0 0 32 0 9 9 9 9 9 9 9 9 9 9 9 9 9 9 9 9 9 9 9 9 9 9 9 9 9 9 9 0 32 0 0 0 8 1
1 8 0 0 32 0 40 0 0 0 0 0 0 0 0 0 0 0 0 0 0 0 0 0 0 0 0 0 0 0 0 0 41 0 32 0 0 0 8 1
1 8 0 0 32 0 40 0 0 3 4 0 0 0 0 0 0 34 35 0 0 0 0 0 0 0 3 4 0 0 0 0 41 0 32 0 0 0 8 1
1 28 28 0 32 0 40 0 0 5 6 0 0 0 0 0 0 36 37 0 0 0 0 0 0 0 5 6 0 0 0 0 41 0 32 0 28 28 33 1
1 27 32 32 32 0 40 0 0 0 0 0 0 26 0 0 0 0 0 0 0 0 26 0 0 0 0 0 0 38 0 0 41 0 32 32 32 29 8 1
1 28 28 0 32 0 40 0 0 3 4 0 0 0 0 0 0 0 0 0 0 0 0 0 0 0 3 4 0 0 0 0 41 0 32 0 28 28 8 1
1 8 0 0 32 0 40 0 0 5 6 0 0 0 0 0 0 0 0 0 0 0 0 0 0 0 5 6 0 0 0 0 41 0 32 0 0 0 8 1
1 8 0 0 32 0 40 0 0 0 0 0 0 0 0 0 0 0 0 0 0 0 0 0 0 0 0 0 0 0 42 42 41 0 32 0 0 0 8 1
1 8 0 0 32 0 40 0 0 0 0 3 4 0 0 0 0 34 35 0 0 0 0 0 3 4 0 0 0 0 42 42 41 0 32 0 0 0 8 1
1 8 0 0 32 0 40 0 0 0 0 5 6 0 0 0 0 36 37 0 0 0 0 0 5 6 0 0 0 0 0 0 41 0 32 0 0 0 8 1
1 8 0 0 32 0 40 0 0 0 0 0 0 0 0 0 0 0 0 0 0 0 0 0 0 0 0 0 0 42 42 42 41 0 32 0 0 0 8 1
1 8 0 0 32 0 9 9 9 9 9 9 9 9 0 0 9 9 9 9 9 9 9 9 9 9 9 9 9 9 9 9 9 0 32 0 0 0 8 1
1 8 0 0 32 0 0 0 0 0 0 0 0 28 0 0 28 0 0 0 0 0 0 0 0 0 0 0 0 0 0 0 0 0 32 0 0 0 8 1
1 8 0 0 32 32 32 32 32 32 32 32 32 32 32 32 32 32 32 32 32 32 32 32 32 32 32 32 32 32 32 32 32 32 32 0 0 0 8 1
1 8 0 0 0 0 0 0 0 0 0 0 0 0 0 0 0 0 0 0 0 0 0 0 0 0 0 0 0 0 0 0 0 0 0 0 0 0 8 1
1 8 0 0 0 0 0 0 0 0 0 0 0 0 0 0 0 0 0 0 0 0 0 0 0 0 0 0 0 0 0 0 0 0 0 0 0 0 8 1
1 8 0 0 0 0 0 0 0 0 0 0 0 0 0 0 0 0 0 0 0 0 0 0 0 0 0 0 0 0 0 0 0 0 0 0 0 0 8 1
1 8 0 0 0 0 0 0 0 0 0 0 0 0 0 0 0 0 0 0 0 0 0 0 0 0 0 0 0 0 0 0 0 0 0 0 0 0 8 1
1 8 0 0 0 0 0 0 0 0 0 0 0 0 0 0 0 0 0 0 0 0 0 0 0 0 0 0 0 0 0 0 0 0 0 0 0 0 8 1
1 8 0 0 0 0 0 0 0 0 0 0 0 0 0 0 0 0 0 0 0 0 0 0 0 0 0 0 0 0 0 0 0 0 0 0 0 0 8 1
1 8 0 11 12 0 0 0 0 11 12 0 0 0 0 11 12 0 0 0 0 11 12 0 0 0 0 11 12 0 0 0 0 11 12 0 0 0 8 1
1 8 0 13 14 0 0 0 0 13 14 0 0 0 0 13 14 0 0 0 0 13 14 0 0 0 0 13 14 0 0 0 0 13 14 0 0 0 8 1
1 8 0 0 0 0 0 0 0 0 0 0 0 0 0 0 0 0 0 0 0 0 0 0 0 0 0 0 0 0 0 0 0 0 0 0 0 0 8 1
1 15 15 15 15 15 15 15 15 15 15 15 15 15 15 15 15 15 15 15 15 15 15 15 15 15 15 15 15 15 15 15 15 15 15 15 15 15 15 1
1 8 8 8 8 8 8 8 8 8 8 8 8 8 8 8 8 8 8 8 8 8 8 8 8 8 8 8 8 8 8 8 8 8 8 8 8 8 8 1
1 1 1 1 1 1 1 1 1 1 1 1 1 1 1 1 1 1 1 1 1 1 1 1 1 1 1 1 1 1 1 1 1 1 1 1 1 1 1 1