1 1 1 1 1 1 1 1 1 1 1 1 1 1 1 1 1 1 1 1 1 1 1 1 1 1 1 1 1 1 1 1 1 1 1 1 1 1 1 1
1 7 7 7 7 7 7 7 7 7 7 7 7 7 7 7 7 7 7 7 7 7 7 7 7 7 7 7 7 7 7 7 7 7 7 7 7 7 7 1
1 33 0 0 3 4 0 0 3 4 0 0 3 4 0 0 3 4 0 0 3 4 0 0 3 4 0 0 3 4 0 0 3 4 0 0 0 0 33 1
1 33 0 0 5 6 0 0 5 6 0 0 5 6 0 0 5 6 0 0 5 6 0 0 5 6 0 0 5 6 0 0 5 6 0 0 0 0 33 1
1 33 9 9 0 0 9 9 0 0 9 9 0 0 9 9 0 0 9 9 0 0 9 9 0 0 9 9 0 0 9 9 0 0 9 9 9 9 33 1
1 33 0 0 30 31 0 0 30 31 0 0 30 31 0 0 30 31 0 0 30 31 0 0 30 31 0 0 30 31 0 0 30 31 0 0 0 0 33 1
1 33 0 0 0 0 0 0 0 0 0 0 0 0 0 0 0 0 0 0 0 0 0 0 0 0 0 0 0 0 0 0 0 0 0 0 0 0 33 1
1 33 0 32 32 32 32 32 32 32 32 32 32 32 32 32 32 32 32 32 32 32 32 32 32 32 32 32 32 32 32 32 32 32 32 32 32 0 33 1
1 33 0 0 0 0 0 32 0 0 0 0 0 0 32 0 0 0 0 0 0 0 32 0 0 0 0 0 0 0 32 0 0 0 0 0 0 0 33 1
1 33 0 0 0 0 0 32 0 0 0 0 0 0 32 0 0 0 0 0 0 0 32 0 0 0 0 0 0 0 32 0 0 0 0 0 0 0 33 1
1 33 0 0 0 0 0 32 0 0 0 0 0 0 32 0 0 0 0 0 0 0 32 0 0 0 0 0 0 0 32 0 0 0 0 0 0 0 33 1
1 33 0 0 0 0 0 32 0 0 0 0 0 0 32 0 0 0 0 0 0 0 32 0 0 0 0 0 0 0 32 0 0 0 0 0 0 0 33 1
1 33 0 0 0 0 0 32 0 0 9 9 0 0 32 0 0 0 9 9 0 0 32 0 0 0 9 9 0 0 32 0 0 0 0 0 0 0 33 1
1 33 28 28 0 0 0 32 0 9 8 8 9 0 32 0 0 9 8 8 9 0 32 0 0 9 8 8 9 0 32 0 0 0 0 0 28 28 33 1
1 33 27 0 0 0 0 32 0 9 8 8 9 0 32 0 0 9 8 8 9 0 32 0 0 9 8 8 9 0 32 0 0 0 0 0 0 29 33 1
1 33 28 28 0 0 0 32 0 0 9 9 0 0 32 0 0 0 9 9 0 0 32 0 0 0 9 9 0 0 32 0 0 0 0 0 28 28 33 1
1 33 0 0 0 0 0 32 0 0 0 0 0 0 32 0 0 0 0 0 0 0 32 0 0 0 0 0 0 0 32 0 0 0 0 0 0 0 33 1
1 33 0 0 0 0 0 32 32 32 32 32 32 32 32 32 32 32 32 32 32 32 32 32 32 32 32 32 32 32 32 0 0 0 0 0 0 0 33 1
1 33 0 0 0 0 0 32 0 0 9 9 0 0 32 0 0 0 9 9 0 0 32 0 0 0 9 9 0 0 32 0 0 0 0 0 0 0 33 1
1 33 0 0 0 0 0 32 0 9 8 8 9 0 32 0 0 9 8 8 9 0 32 0 0 9 8 8 9 0 32 0 0 0 0 0 0 0 33 1
1 33 0 0 0 0 0 32 0 9 8 8 9 0 32 0 0 9 8 8 9 0 32 0 0 9 8 8 9 0 32 0 0 0 0 0 0 0 33 1
1 33 0 0 0 0 0 32 0 0 9 9 0 0 32 0 0 0 9 9 0 0 32 0 0 0 9 9 0 0 32 0 0 0 0 0 0 0 33 1
1 33 0 0 0 0 0 32 0 0 0 0 0 0 32 0 0 0 0 0 0 0 32 0 0 0 0 0 0 0 32 0 0 0 0 0 0 0 33 1
1 33 0 0 0 0 0 32 32 32 32 32 32 32 32 32 32 32 32 32 32 32 32 32 32 32 32 32 32 32 32 0 0 0 0 0 0 0 33 1
1 33 0 0 0 0 0 0 0 0 0 0 0 0 0 0 0 0 0 0 0 0 0 0 0 0 0 0 0 0 0 0 0 0 0 0 0 0 33 1
1 33 0 0 0 0 0 0 0 0 0 0 0 0 0 0 0 0 0 0 0 0 0 0 0 0 0 0 0 0 0 0 0 0 0 0 0 0 33 1
1 33 0 0 0 0 0 0 0 0 0 0 0 0 0 0 0 0 0 0 0 0 0 0 0 0 0 0 0 0 0 0 0 0 0 0 0 0 33 1
1 33 0 0 0 0 0 0 0 0 0 0 0 0 0 0 0 0 0 0 0 0 0 0 0 0 0 0 0 0 0 0 0 0 0 0 0 0 33 1
1 33 0 0 0 0 0 0 0 0 0 0 0 0 0 0 0 0 0 0 0 0 0 0 0 0 0 0 0 0 0 0 0 0 0 0 0 0 33 1
1 33 0 0 0 0 0 0 0 0 0 0 0 0 0 0 0 0 0 0 0 0 0 0 0 0 0 0 0 0 0 0 0 0 0 0 0 0 33 1
1 33 0 0 0 0 0 0 0 0 0 0 0 0 0 0 0 0 0 0 0 0 0 0 0 0 0 0 0 0 0 0 0 0 0 0 0 0 33 1
1 0 0 33 0 33 0 33 0 33 0 33 0 33 0 33 0 33 0 33 0 33 0 33 0 33 0 33 0 33 0 33 0 33 0 33 0 33 0 1
1 7 7 7 7 7 7 7 7 7 7 7 7 7 7 7 7 7 7 7 7 7 7 7 7 7 7 7 7 7 7 7 7 7 7 7 7 7 7 1
1 0 0 0 0 0 0 0 0 0 0 0 0 0 0 0 0 0 0 0 0 0 0 0 0 0 0 0 0 0 0 0 0 0 0 0 0 0 0 1
1 1 1 1 1 1 1 1 1 1 1 1 1 1 1 1 1 1 1 1 1 1 1 1 1 1 1 1 1 1 1 1 1 1 1 1 1 1 1 1